a (межд.)	 1. ах, о, ха 2. за подчертаване или потвърждение. 3. за обозначаване на ономатопея.
a (прил.)	 за подчертаване или потвърждаване на предходната дума
akesi (същ.)	1. влечуго или земноводно. 2. страшно или грозно създание.
akesi (прил.)	влечуго или земноводно
akesi (гл.)	да се превърне във влечуго или земноводно
ala (същ.)	1. нищо. 2. отрицание.
ala (числ.)	нула
ala (прил.)	никакво
ala (гл.)	1. да не прави нищо. 2. да анулира или унищожи.
ala (нареч.)	не
ala (межд.)	не
alasa (гл.)	1. да ловува, насилствено или ненасилствено, да издирва, да търси. 2. да събира, да жъне. 3. да опита.
alasa (същ.)	лов, издирване или търсене
ale (същ.)	1. всичко. 2. живот или съществуване. 3. вселената, всичко, което съществува. 4. изобилие. 
ale (прил.)	1. всички, всеки или всяко. 2. пълно, общо, цяло. 3. изобилно, безбройно, щедро.
ale (гл.)	1. да прониква навсякъде, да бъде във всичко или във всяка част. 2. да се превърне в стока, да се направи универсално или всеобщо.
ale (числ.)	сто
anpa (същ.)	1. дъното или подът. 2. долната част, мястото под нея.
anpa (гл.)	1. да се поклони. 2. да понижи, да победи.
anpa (прил.)	1. ниско или на дъното. 2. надолно. 3. скромно, смирено.
anpa (нареч.)	надолу
ante (същ.)	1. разлика. 2. промяна или изменение.
ante (гл.)	1. да се различава. 2. да промени, да измени, да модифицира.
ante (прил.)	1. друго. 2. различно. 3. променено.
ante (сз.)	използва се преди la. 1. в противен случай. 2. или иначе. 3. така или иначе.
